"context"	"target"
"key"	"text"
"#Loc;1;text/!!!xyy_roguelike.loc"	""
"mod_xyy_roguelike_icon_earth"	"[[img:character_attribute_authority]][[/img]]"
"mod_xyy_roguelike_description_earth"	"[[img:character_attribute_authority]][[/img]]每增加一點，派系範圍士氣+2，人物滿意度+1"
"mod_xyy_roguelike_icon_fire"	"[[img:character_attribute_instinct]][[/img]]"
"mod_xyy_roguelike_description_fire"	"[[img:character_attribute_instinct]][[/img]]每增加一點，派系範圍部隊所有傷害+3%，部隊維持費-1%"
"mod_xyy_roguelike_icon_metal"	"[[img:character_attribute_expertise]][[/img]]"
"mod_xyy_roguelike_description_metal"	"[[img:character_attribute_expertise]][[/img]]每增加一點，派系範圍部隊傷害抗性+1%，建築維持費-2%"
"mod_xyy_roguelike_icon_water"	"[[img:character_attribute_cunning]][[/img]]"
"mod_xyy_roguelike_description_water"	"[[img:character_attribute_cunning]][[/img]]每增加一點，派系範圍部隊箭矢容量+2%，產值（所有來源）+1%"
"mod_xyy_roguelike_icon_wood"	"[[img:character_attribute_resolve]][[/img]]"
"mod_xyy_roguelike_description_wood"	"[[img:character_attribute_resolve]][[/img]]每增加一點，派系範圍將領生命值+2%，人口增長+1000"
"dilemmas_localised_title_roguelike_dilemma"	"是否開啟「逐鹿天下」？"
"dilemmas_localised_description_roguelike_dilemma"	"「逐鹿天下」模式將會隨機分配地圖，一旦啟用，將會取消目前的所有任務，並且禁用卡芙卡劇情（卡芙卡將直接獲得專屬武器和坐騎）。 \\n注意：此操作不可逆。根據您的硬體配置，重新產生地圖可能需要幾分鐘的時間，請耐心等待。"
"cdir_events_dilemma_choice_details_localised_choice_label_roguelike_dilemmaFIRST"	"「逐鹿天下」"
"cdir_events_dilemma_choice_details_localised_choice_label_roguelike_dilemmaSECOND"	"正常模式"
"dilemmas_localised_title_roguelike_dilemma_continue"	"繼續「逐鹿天下」"
"dilemmas_localised_description_roguelike_dilemma_continue"	"偵測到未完成的武將選擇或賜福選擇的存檔，該存檔可能已經損壞，點擊繼續將嘗試修復"
"cdir_events_dilemma_choice_details_localised_choice_label_roguelike_dilemma_continueFIRST"	"繼續"
"uied_component_texts_localised_string_title_NewState_Text_2000005"	"[[col:flavour]]選擇賜福[[/col]]"
"uied_component_texts_localised_string_title_NewState_Text_2000006"	"[[col:flavour]]逐鹿商店[[/col]]"
"mod_xyy_roguelike_info"	"滑鼠懸停查看詳細||"
"effect_bundles_localised_title_xyy_roguelike_1"	"民心所向"
"effect_bundles_localised_description_xyy_roguelike_1"	"你的領地被佔領後，一年內若沒有失去新的領地，則強制收回該領地"
"mod_info_xyy_roguelike_1"	"當你的領地被佔領後，將「民心」標記至該領地，5回合後，你會重新獲得「民心」所標記的領地；在此期間你若有另一個領地被佔領，則刷新倒數計時，將「民心」標記至新失去的領地；你以其他手段控制領地後，清除「民心」標記只能存在1個人民標記；"
"effect_bundles_localised_title_xyy_roguelike_2"	"敗而不餒"
"effect_bundles_localised_description_xyy_roguelike_2"	"當你打出一敗塗地或悲慘失敗，在一定時間內增加派系內的滿意度和部隊補員"
"mod_info_xyy_roguelike_2"	"當你戰鬥結果為 一敗塗地 或 悲慘失敗 ，派系範圍內的補員增加25%，人物滿意度增加50，持續5回合"
"effect_bundles_localised_title_xyy_roguelike_3"	"勝者為王"
"effect_bundles_localised_description_xyy_roguelike_3"	"當你打出酣暢大勝或史詩大捷，一定時間內派系範圍獲得不潰"
"mod_info_xyy_roguelike_3"	"當你戰鬥結果為 酣暢大勝 或 史詩大捷 ，派系範圍內獲得不潰效果，持續5回合"
"effect_bundles_localised_title_xyy_roguelike_4"	"天下歸心"
"effect_bundles_localised_description_xyy_roguelike_4"	"你更容易俘虜敵方武將，而你的武將更難被敵人俘獲"
"mod_info_xyy_roguelike_4"	"派系範圍所有武將避免被俘的機率增加50%，俘獲敵方將領的機率增加25%"
"effect_bundles_localised_title_xyy_roguelike_5"	"農業發達"
"effect_bundles_localised_description_xyy_roguelike_5"	"你的糧食產量和農業產值增加"
"mod_info_xyy_roguelike_5"	"派系範圍內，所有領地糧食產量+5，農業產值+200%"
"effect_bundles_localised_title_xyy_roguelike_6"	"商業發達"
"effect_bundles_localised_description_xyy_roguelike_6"	"你可以簽訂更多貿易協議，貿易影響和商業產值都有增加"
"mod_info_xyy_roguelike_6"	"派系範圍內，可用貿易協定數量+2，商業產值+200%，貿易影響+500%"
"effect_bundles_localised_title_xyy_roguelike_7"	"軍工發達"
"effect_bundles_localised_description_xyy_roguelike_7"	"你的部曲維持費降低，工業產值增加"
"mod_info_xyy_roguelike_7"	"派系範圍內，部曲維持費-50%，工業產值+200%"
"effect_bundles_localised_title_xyy_roguelike_8"	"星神助我"
"effect_bundles_localised_description_xyy_roguelike_8"	"(5回合)你可以直接進行一次命途祈福，不論阮・梅是否存在，你解鎖命途祈福功能"
"mod_info_xyy_roguelike_8"	"直接進行一次命途祈福，效果持續到下一年的春季；5回合後，回收此「賜福」"
"effect_bundles_localised_title_xyy_roguelike_9"	"日益精進"
"effect_bundles_localised_description_xyy_roguelike_9"	"武將可獲得更多經驗"
"mod_info_xyy_roguelike_9"	"所有將領的人物經驗成長+200%"
"effect_bundles_localised_title_xyy_roguelike_10"	"屯田積糧"
"effect_bundles_localised_description_xyy_roguelike_10"	"增加部隊的補給，並且你不會再因為補給短缺而遭受損耗"
"mod_info_xyy_roguelike_10"	"所有軍隊補給+30，並且免疫補給短缺造成的部隊損耗"
"effect_bundles_localised_title_xyy_roguelike_11"	"千錘百煉"
"effect_bundles_localised_description_xyy_roguelike_11"	"增加部隊的維持費，強化部隊的進攻、防禦等屬性"
"mod_info_xyy_roguelike_11"	"派系範圍內，部曲維持費+30%，部隊近戰與遠程殺傷+200%，近戰閃避+50%"
"effect_bundles_localised_title_xyy_roguelike_12"	"強制徭役"
"effect_bundles_localised_description_xyy_roguelike_12"	"部曲徵募費用降低，但增加部隊集結時間"
"mod_info_xyy_roguelike_12"	"派系範圍內，部曲徵募費用-90%，集結時間+50%"
"effect_bundles_localised_title_xyy_roguelike_13"	"後勤支援"
"effect_bundles_localised_description_xyy_roguelike_13"	"部隊在境外可補員"
"mod_info_xyy_roguelike_13"	"派系範圍內，境外補員速率+20%"
"effect_bundles_localised_title_xyy_roguelike_14"	"兵貴神速"
"effect_bundles_localised_description_xyy_roguelike_14"	"部隊可移動範圍大幅提升"
"mod_info_xyy_roguelike_14"	"每季的部隊行動點數+100%"
"effect_bundles_localised_title_xyy_roguelike_15"	"並且無大礙"
"effect_bundles_localised_description_xyy_roguelike_15"	"你的將領在輕傷狀態下可獲得增益，再次受傷或恢復健康後移除增益"
"mod_info_xyy_roguelike_15"	"當武將的韌性值等於其韌性上限-1的時候，武將的基礎殺傷+200%，破甲殺傷+200%，生命上限+200%，移動速度+50%，"
"effect_bundles_localised_title_xyy_roguelike_16"	"年少有為"
"effect_bundles_localised_description_xyy_roguelike_16"	"派系內年輕人物越多，所有武將經驗增加得越快"
"mod_info_xyy_roguelike_16"	"你的派系內每有一個20歲以下的人物，派系範圍內所有人物經驗增長+20%，最高可疊加10層"
"effect_bundles_localised_title_xyy_roguelike_17"	"老驥伏櫪"
"effect_bundles_localised_description_xyy_roguelike_17"	"派系內年長人物越多，所有部隊士氣增加"
"mod_info_xyy_roguelike_17"	"你的派系內每有一個50歲以上的人物，派系範圍內部隊士氣+5，最高可疊加10層"
"effect_bundles_localised_title_xyy_roguelike_18"	"力大磚飛"
"effect_bundles_localised_description_xyy_roguelike_18"	"所有部隊破甲傷害大幅增加，但失去所有非破甲殺傷"
"mod_info_xyy_roguelike_18"	"派系範圍內，所有部隊的破甲殺傷+200%，非破甲傷害-100%"
"effect_bundles_localised_title_xyy_roguelike_19"	"後備計劃"
"effect_bundles_localised_description_xyy_roguelike_19"	"若你輸掉了進攻戰，恢復軍隊的行動點數"
"mod_info_xyy_roguelike_19"	"若你作為進攻方輸掉了戰鬥，該部隊的行動點數恢復至回合開始的狀態"
"effect_bundles_localised_title_xyy_roguelike_20"	"反貪腐廉政"
"effect_bundles_localised_description_xyy_roguelike_20"	"你的派系腐敗大幅降低"
"mod_info_xyy_roguelike_20"	"派系範圍內，腐敗-70%"
"effect_bundles_localised_title_xyy_roguelike_21"	"多勞多得"
"effect_bundles_localised_description_xyy_roguelike_21"	"你佔領地區可獲得更多資源[[img:pooled_resource_credibility]][[/img]]"
"mod_info_xyy_roguelike_21"	"你佔領地區所獲得的資源[[img:pooled_resource_credibility]][[/img]]數量+10"
"effect_bundles_localised_title_xyy_roguelike_22"	"取之不竭"
"effect_bundles_localised_description_xyy_roguelike_22"	"回合結束時，如果府庫少於2000，則額外獲得5000"
"mod_info_xyy_roguelike_22"	"回合結束時，如果府庫少於2000，則額外獲得5000"
"effect_bundles_localised_title_xyy_roguelike_23"	"緊急求援"
"effect_bundles_localised_description_xyy_roguelike_23"	"(5回合)你可以立即抽取一次角色，但派系範圍內人物滿意度內因此減少"
"mod_info_xyy_roguelike_23"	"立即抽出一次角色，派系範圍內，人物滿意度-75，持續5回合；持續回合結束後，收回此「賜福」"
"effect_bundles_localised_title_xyy_roguelike_24"	"大力建設"
"effect_bundles_localised_description_xyy_roguelike_24"	"你的城市建設更快，費用更低，可以進行更多建設"
"mod_info_xyy_roguelike_24"	"派系範圍內，建造時間-1,建造成本-50%，額外建造數量+2"
"effect_bundles_localised_title_xyy_roguelike_25"	"吾乃天命"
"effect_bundles_localised_description_xyy_roguelike_25"	"(15回合)強制改變非玩家派系的「逐鹿之勢」"
"mod_info_xyy_roguelike_25"	"非玩家派系的「逐鹿之勢」（「天命之勢」、「固守之勢」、「巧變之勢」、「勇武之勢」、「破軍之勢」）改變；15回合後，收回此「賜福」"
"effect_bundles_localised_title_xyy_roguelike_26"	"鴻餛飩之志"
"effect_bundles_localised_description_xyy_roguelike_26"	"我方派人物滿意度增加，敵對派係人物滿意度降低"
"mod_info_xyy_roguelike_26"	"派系範圍內人物滿意度+20，敵對派係人物滿意度-20"
"effect_bundles_localised_title_xyy_roguelike_27"	"全神貫注"
"effect_bundles_localised_description_xyy_roguelike_27"	"所有技能冷卻時間降低"
"mod_info_xyy_roguelike_27"	"派系範圍內，武將技能冷卻時間-25%"
"effect_bundles_localised_title_xyy_roguelike_28"	"堅甲利刃"
"effect_bundles_localised_description_xyy_roguelike_28"	"部隊近戰閃避攻速提高"
"mod_info_xyy_roguelike_28"	"派系範圍部隊近戰閃避+50%，近戰攻速+100%"
"effect_bundles_localised_title_xyy_roguelike_29"	"浴火重生"
"effect_bundles_localised_description_xyy_roguelike_29"	"你的人物和軍隊免疫火焰傷害"
"mod_info_xyy_roguelike_29"	"派系範圍，武將和部曲火焰抗性+100%"
"effect_bundles_localised_title_xyy_roguelike_30"	"突騎橫行"
"effect_bundles_localised_description_xyy_roguelike_30"	"軍隊的衝鋒加成提升"
"mod_info_xyy_roguelike_30"	"派系範圍，武將和部曲衝鋒加成提升+30%"
"effect_bundles_localised_title_xyy_roguelike_31"	"科技強國"
"effect_bundles_localised_description_xyy_roguelike_31"	"你可以在每年夏季進行一次改革"
"mod_info_xyy_roguelike_31"	"你可以在每年夏季進行一次改革，若你在本回合已經進行了一次改革，則順延至這一年的秋收"
"effect_bundles_localised_title_xyy_roguelike_32"	"臥龍出山"
"effect_bundles_localised_description_xyy_roguelike_32"	"諸葛亮加入陣營"
"mod_info_xyy_roguelike_32"	"傳奇軍師諸葛亮加入派系"
"effect_bundles_localised_title_xyy_roguelike_33"	"遊擊擾敵"
"effect_bundles_localised_description_xyy_roguelike_33"	"若你的城市遭到圍攻，敵軍將會承受高額的補給消耗"
"mod_info_xyy_roguelike_33"	"你被圍攻的城市領地範圍內的敵軍軍隊補給-100"
"effect_bundles_localised_title_xyy_roguelike_34"	"堅韌不拔"
"effect_bundles_localised_description_xyy_roguelike_34"	"增加武將的韌性"
"mod_info_xyy_roguelike_34"	"派系範圍內，武將韌性+1"
"effect_bundles_localised_title_xyy_roguelike_35"	"穩如泰山"
"effect_bundles_localised_description_xyy_roguelike_35"	"部隊可以抵抗衝鋒，反制騎兵衝鋒"
"mod_info_xyy_roguelike_35"	"派系範圍內，軍隊解鎖抵抗衝鋒、反制騎兵衝鋒能力"
"effect_bundles_localised_title_xyy_roguelike_36"	"神出鬼沒"
"effect_bundles_localised_description_xyy_roguelike_36"	"伏擊必定成功"
"mod_info_xyy_roguelike_36"	"派系範圍內，軍隊伏擊成功率+100%"
"effect_bundles_localised_title_xyy_roguelike_37"	"覆軍殺將"
"effect_bundles_localised_description_xyy_roguelike_37"	"在佔領派系最後一座城市後，不論該派係是否還有軍隊，將直接覆滅"
"mod_info_xyy_roguelike_37"	"在佔領派系最後一座城市後，不論該派係是否還有軍隊，將直接覆滅"
"effect_bundles_localised_title_xyy_roguelike_38"	"背水一戰"
"effect_bundles_localised_description_xyy_roguelike_38"	"如果你的軍隊已經撤退過，再次遭遇攻擊時獲得不潰，且無法被俘"
"mod_info_xyy_roguelike_38"	"你的軍隊在防守時，如果這一回合已經撤退過一次，則獲得不潰"
"effect_bundles_localised_title_xyy_roguelike_39"	"勢如破竹"
"effect_bundles_localised_description_xyy_roguelike_39"	"當你進攻時取得一場勝利，將恢復軍隊的行動點數"
"mod_info_xyy_roguelike_39"	"若你作為進攻方贏得了戰鬥，此部隊的行動點數恢復至回合開始的狀態"
"effect_bundles_localised_title_xyy_roguelike_40"	"國富民強"
"effect_bundles_localised_description_xyy_roguelike_40"	"你的十級城市腐敗減少"
"mod_info_xyy_roguelike_40"	"你的十級城市腐敗-100%"
"effect_bundles_localised_title_xyy_roguelike_41"	"手到擒來"
"effect_bundles_localised_description_xyy_roguelike_41"	"你成功發動伏擊並取勝，敵方將領逃跑幾率降低"
"mod_info_xyy_roguelike_41"	"當你成功發動伏擊並取勝時，敵方將領逃脫的幾率-100%"
"effect_bundles_localised_title_xyy_roguelike_42"	"無懈可擊"
"effect_bundles_localised_description_xyy_roguelike_42"	"你的部曲免疫淬毒、流血傷害"
"mod_info_xyy_roguelike_42"	"你的部曲淬毒、出血傷害抗性+100%"
"effect_bundles_localised_title_xyy_roguelike_43"	"臨危險受命"
"effect_bundles_localised_description_xyy_roguelike_43"	"你的太守位增加"
"mod_info_xyy_roguelike_43"	"可用太守位+2"
"effect_bundles_localised_title_xyy_roguelike_44"	"毫髮無損"
"effect_bundles_localised_description_xyy_roguelike_44"	"你的武將不會殘疾"
"mod_info_xyy_roguelike_44"	"你的武將不會獲得殘障特性，且恢復的回合數-1"
"effect_bundles_localised_title_xyy_roguelike_45"	"精神煥發"
"effect_bundles_localised_description_xyy_roguelike_45"	"所有武將免疫疲勞"
"mod_info_xyy_roguelike_45"	"派系範圍內，武將獲得免疫疲勞特性"
"effect_bundles_localised_title_xyy_roguelike_46"	"一臂之力"
"effect_bundles_localised_description_xyy_roguelike_46"	"武將支援範圍大幅增加"
"mod_info_xyy_roguelike_46"	"派系範圍內，武將支援範圍+100%"
"effect_bundles_localised_title_xyy_roguelike_47"	"特製箭矢"
"effect_bundles_localised_description_xyy_roguelike_47"	"部隊遠程殺傷大幅增加，但是彈藥量減少"
"mod_info_xyy_roguelike_47"	"派系範圍內，遠程傷害+100%，遠程彈藥量-30%"
"effect_bundles_localised_title_xyy_roguelike_48"	"豪華都市"
"effect_bundles_localised_description_xyy_roguelike_48"	"你的十級城市減免所有建築維護費"
"mod_info_xyy_roguelike_48"	"所有十級城市的建築維護費-100%"
"effect_bundles_localised_title_xyy_roguelike_49"	"安居樂業"
"effect_bundles_localised_description_xyy_roguelike_49"	"你的十級城市糧食產量大幅增加"
"mod_info_xyy_roguelike_49"	"所有十級城市的糧食產量+100%"
"effect_bundles_localised_title_xyy_roguelike_50"	"國庫充盈"
"effect_bundles_localised_description_xyy_roguelike_50"	"(1回合)你每有一座十級城市，可獲得30[[img:pooled_resource_credibility]][[/img]]"
"mod_info_xyy_roguelike_50"	"你每擁有一座十級城市，可獲得30[[img:pooled_resource_credibility]][[/img]]；1回合後，收回此「賜福」"
"effect_bundles_localised_title_xyy_roguelike_51"	"孤注一擲"
"effect_bundles_localised_description_xyy_roguelike_51"	"(1回合)你可以立即抽取一次角色，但失去所有的[[img:pooled_resource_credibility]][[/img]]，你有機率再抽取一次角色"
"mod_info_xyy_roguelike_51"	"你失去所有的[[img:pooled_resource_credibility]][[/img]]並立即抽取一次角色，選擇完角色之後，你有50%機率再選擇一次角色；1回合後，收回此「賜福」"
"effect_bundles_localised_title_xyy_roguelike_the_seven_kings"	"華夏助威"
"effect_bundles_localised_description_xyy_roguelike_the_seven_kings"	"立即集齊華夏七王"
"mod_info_xyy_roguelike_the_seven_kings"	"獲得華夏七王的所有人物，如果已經獲得其中部分人物，則獲得剩餘的人物"
"effect_bundles_localised_title_xyy_roguelike_max_1"	"額外選項I"
"effect_bundles_localised_description_xyy_roguelike_max_1"	"增加一個祝福選項"
"mod_info_xyy_roguelike_max_1"	"選擇「賜福」時，備選「賜福」清單上限+1"
"effect_bundles_localised_title_xyy_roguelike_max_2"	"額外選項II"
"effect_bundles_localised_description_xyy_roguelike_max_2"	"增加一個祝福選項"
"mod_info_xyy_roguelike_max_2"	"選擇「賜福」時，備選「賜福」清單上限+1"
"effect_bundles_localised_title_xyy_roguelike_max_3"	"額外選項III"
"effect_bundles_localised_description_xyy_roguelike_max_3"	"增加一個祝福選項"
"mod_info_xyy_roguelike_max_3"	"選擇「賜福」時，備選「賜福」清單上限+1"
"effect_bundles_localised_title_xyy_roguelike_max_4"	"額外選項IV"
"effect_bundles_localised_description_xyy_roguelike_max_4"	"增加一個祝福選項"
"mod_info_xyy_roguelike_max_4"	"選擇「賜福」時，備選「賜福」清單上限+1"
"effect_bundles_localised_title_xyy_roguelike_max_character_browser_1"	"後備人物I"
"effect_bundles_localised_description_xyy_roguelike_max_character_browser_1"	"增加一個角色備選數量"
"mod_info_xyy_roguelike_max_characte_browserr_1"	"備選角色數量上限+1，如果剩餘備選角色數量少於目前上限，則只顯示剩餘的備選角色"
"effect_bundles_localised_title_xyy_roguelike_max_character_browser_2"	"後備人物II"
"effect_bundles_localised_description_xyy_roguelike_max_character_browser_2"	"增加一個角色備選數量"
"mod_info_xyy_roguelike_max_character_browser_2"	"備選角色數量上限+1，如果剩餘備選角色數量少於目前上限，則只顯示剩餘的備選角色"
"effect_bundles_localised_title_xyy_roguelike_max_character_browser_3"	"後備人物III"
"effect_bundles_localised_description_xyy_roguelike_max_character_browser_3"	"增加一個角色備選數量"
"mod_info_xyy_roguelike_max_character_browser_3"	"備選角色數量上限+1，如果剩餘備選角色數量少於目前上限，則只顯示剩餘的備選角色"
"effect_bundles_localised_title_xyy_roguelike_max_character_browser_4"	"後備人物IV"
"effect_bundles_localised_description_xyy_roguelike_max_character_browser_4"	"增加一個角色備選數量"
"mod_info_xyy_roguelike_max_character_browser_4"	"備選角色數量上限+1，如果剩餘備選角色數量少於目前上限，則只顯示剩餘的備選角色"
"effect_bundles_localised_title_xyy_roguelike_max_character_1"	"我全都要"
"effect_bundles_localised_description_xyy_roguelike_max_character_1"	"增加一個角色可選數量"
"mod_info_xyy_roguelike_max_character_1"	"角色可選數量+1。如果剩餘可選角色數量少於備選角色數量，則只能選擇目前的備選角色"
"mod_xyy_roguelike_confirm"	"餘額："
"mod_xyy_roguelike_confirm_wait"	"結算"
"campaign_diplomacy_treaty_availability_reasons_description_roguelike_mode"	"\\n[[col:red]]「逐鹿天下」模式無法進行此類外交。 [[/col]]"
"mission_text_text_treaty_components_war"	"選擇一個派系宣戰"
"missions_localised_title_xyy_roguelike_mission_ready"	"「逐鹿天下」準備階段"
"missions_localised_description_xyy_roguelike_mission_ready"	"準備好之後請選擇一個派系宣戰並及時消滅對方則可以獲得獎勵，若倒數結束之後你仍沒有宣戰，則此次逐鹿天下模式將[[b]]宣告失敗[[/b]]。"
"effect_bundles_localised_title_xyy_roguelike_redraw_1"	"不甘現狀"
"effect_bundles_localised_description_xyy_roguelike_redraw_1"	"你可以刷新一次祝福選擇"
"mod_info_xyy_roguelike_redraw_1"	"你每次選擇賜福時，都可以刷新一次。"
"missions_localised_title_xyy_roguelike_mission_easy"	"「逐鹿天下」消滅目標"
"missions_localised_description_xyy_roguelike_mission_easy"	"一舉消滅目標，如果你能在更快的時間內消滅對方，可能會獲得更多獎勵"
"campaign_payload_ui_details_description_xyy_roguelike_mission_easy"	"[[img:pooled_resource_credibility]][[/img]]+100\\n10回合內完成可額外取得：[[img:pooled_resource_credibility]][[/img]]+50"
"missions_localised_title_xyy_roguelike_mission_normal"	"「逐鹿天下」消滅目標"
"missions_localised_description_xyy_roguelike_mission_normal"	"一舉消滅目標，如果你能在更快的時間內消滅對方，可能會獲得更多獎勵"
"campaign_payload_ui_details_description_xyy_roguelike_mission_normal"	"[[img:pooled_resource_credibility]][[/img]]+200\\n15回合內完成可額外取得：[[img:pooled_resource_credibility]][[/img]]+100"
"missions_localised_title_xyy_roguelike_mission_hard"	"「逐鹿天下」消滅目標"
"missions_localised_description_xyy_roguelike_mission_hard"	"一舉消滅目標，如果你能在更快的時間內消滅對方，可能會獲得更多獎勵"
"campaign_payload_ui_details_description_xyy_roguelike_mission_hard"	"[[img:pooled_resource_credibility]][[/img]]+400\\n20回合內完成可額外取得：[[img:pooled_resource_credibility]][[/img]]+200"
"missions_localised_title_xyy_roguelike_mission_xyyhlyjf"	"「逐鹿天下」消滅目標"
"missions_localised_description_xyy_roguelike_mission_xyyhlyjf"	"主公不斷南徵北戰，興復漢室，如今的目標只剩下不可一世的幻朧了，是時候與之一決雌雄了"
"campaign_payload_ui_details_description_xyy_roguelike_mission_xyyhlyjf"	"戰役勝利"
"mod_xyy_character_roguelike_select"	"[[col:flavour]]選擇加入的角色[[/col]]"
"mod_xyy_character_roguelike_select_first"	"[[col:flavour]]選擇您的初始角色[[/col]]"
"dilemmas_localised_title_roguelike_dilemma_first_select"	"逐鹿天下規則簡介"
"dilemmas_localised_description_roguelike_dilemma_first_select"	"[[col:effect_icon_supplement_negative]][[b]]如果你是第一次遊玩「逐鹿天下」模式，強烈建議閱讀模式規則[[/b]][[/col]]\\n\\n1. 該模式將會隨機分配勢力地圖，其中包含反物質軍團，12~14個主要勢力和主要力量\n個主要力量\n個主要力量\n個主要力量\20n. 、聯軍或同盟），但對次要勢力的外交不做限制；\\n\\n3. 玩家一次只能向一個主要勢力宣戰，並且中途不可議和。非法宣戰或被AI宣戰會直接強制和平。對次要勢力則無此限制。玩家不可向反物質軍團宣戰；\\n\\n4. 開局將隨機獲得一個「逐鹿之勢」，不同「逐鹿之勢」對AI有著不一樣的加成。一共有5種「逐鹿之勢」：天命、破軍、勇武、固守、巧變；\\n\\n5. 隨著玩家消滅主要勢力，「逐鹿之勢」等級會逐步提升，最大等級為6級；\\n\\n6.你，一定要謹慎迎戰；\\n\\n7. 「逐鹿之勢」達到最高時，反物質軍團會主動與玩家開戰。此時玩家對於其他派系的外交將全部解除限制，但不可與反物質軍團進行外交；\\n\\n8. 開局時，反物質軍團默認會獲得一個皇位，在擊敗反物質軍團之前你將無法佔領該皇位，這麼做是為了防止由於攻下所有皇位而導致的戰役提前征服並結算；\n\n 軍團。 ；\\n\\n10. 在3次成功擊敗幻朧後，幻朧將會死亡，反物質軍團將會在下一回合直接覆滅，此次「逐鹿天下」也宣告勝利；"
"cdir_events_dilemma_choice_details_localised_choice_label_roguelike_dilemma_first_selectFIRST"	"我已知悉"
"missions_localised_title_xyy_roguelike_mission_boss"	"「逐鹿天下」迎戰幻朧"
"missions_localised_description_xyy_roguelike_mission_boss"	"主公，如今我等已傲視群雄，今可與幻朧一戰！"
"missions_localised_title_xyy_roguelike_mission_boss_2"	"「逐鹿天下」再戰幻朧"
"missions_localised_description_xyy_roguelike_mission_boss_2"	"主公，幻朧敗走，我等且當乘勝追擊！"
"missions_localised_title_xyy_roguelike_mission_boss_3"	"「逐鹿天下」最終決戰"
"missions_localised_description_xyy_roguelike_mission_boss_3"	"主公，這次我們不能再讓幻朧逃跑了，我們定要讓她死於我軍刀下！"
"incidents_localised_title_roguelike_info_ticket"	"「逐鹿天下」提示：佔領地區"
"incidents_localised_description_roguelike_info_ticket"	"佔領地區可以獲得資源[[img:pooled_resource_credibility]][[/img]]\\n佔領主要城市可以獲得[[img:pooled_resource_credibility]][[/img]]+50\\n佔領資源城鎮可以取得[[img:pooled_resource_cibility][ redibility]][[/img]]\\n每積攢200點[[img:pooled_resource_credibility]][[/img]]可以抽取一次「賜福」(不會扣除[[img:pooled_resource_credibility]][[/img]])"
"incidents_localised_title_xyy_roguelike_enemy_earth_1"	"「天命之勢」"
"incidents_localised_description_xyy_roguelike_enemy_earth_1"	"非玩家派系腐敗減少，公共秩序增加；戰場上表現為不潰和遠程抗性，但抵抗衝鋒能力大幅削弱。 \\n\\n對遠程單位和依賴遠程攻擊和技能的武將會很不友善；\\n\\n可利用騎兵和增強衝擊騎兵的武將快速擊破敵軍。"
"incidents_localised_title_xyy_roguelike_enemy_earth_2"	"「天命之勢」等級提高：2級"
"incidents_localised_description_xyy_roguelike_enemy_earth_2"	"非玩家派系腐敗減少，公共秩序增加；戰場上表現為不潰和遠程抗性，但抵抗衝鋒能力大幅削弱。 \\n\\n對遠程單位和依賴遠程攻擊和技能的武將會很不友善；\\n\\n可利用騎兵和增強衝擊騎兵的武將快速擊破敵軍。"
"incidents_localised_title_xyy_roguelike_enemy_earth_3"	"「天命之勢」等級提高：3級"
"incidents_localised_description_xyy_roguelike_enemy_earth_3"	"非玩家派系腐敗減少，公共秩序增加；戰場上表現為不潰和遠程抗性，但抵抗衝鋒能力大幅削弱。 \\n\\n對遠程單位和依賴遠程攻擊和技能的武將會很不友善；\\n\\n可利用騎兵和增強衝擊騎兵的武將快速擊破敵軍。"
"incidents_localised_title_xyy_roguelike_enemy_earth_4"	"「天命之勢」等級提高：4級"
"incidents_localised_description_xyy_roguelike_enemy_earth_4"	"非玩家派系腐敗減少，公共秩序增加；戰場上表現為不潰和遠程抗性，但抵抗衝鋒能力大幅削弱。 \\n\\n對遠程單位和依賴遠程攻擊和技能的武將會很不友善；\\n\\n可利用騎兵和增強衝擊騎兵的武將快速擊破敵軍。"
"incidents_localised_title_xyy_roguelike_enemy_earth_5"	"「天命之勢」等級提高：5級"
"incidents_localised_description_xyy_roguelike_enemy_earth_5"	"非玩家派系腐敗減少，公共秩序增加；戰場上表現為不潰和遠程抗性，但抵抗衝鋒能力大幅削弱。 \\n\\n對遠程單位和依賴遠程攻擊和技能的武將會很不友善；\\n\\n可利用騎兵和增強衝擊騎兵的武將快速擊破敵軍。"
"incidents_localised_title_xyy_roguelike_enemy_earth_6"	"「天命之勢」已達最高等級：6級"
"incidents_localised_description_xyy_roguelike_enemy_earth_6"	"非玩家派系腐敗減少，公共秩序增加；戰場上表現為不潰和遠程抗性，但抵抗衝鋒能力大幅削弱。 \\n\\n對遠程單位和依賴遠程攻擊和技能的武將會很不友善；\\n\\n可利用騎兵和增強衝擊騎兵的武將快速擊破敵軍。"
"incidents_localised_title_xyy_roguelike_enemy_wood_1"	"「勇武之勢」"
"incidents_localised_description_xyy_roguelike_enemy_wood_1"	"非玩家派系軍隊補給增加，支援範圍增加；戰場上表現為更高的武將格鬥能力，但士兵能力大幅削弱。 \\n\\n敵方武將會增強自身與周圍士兵的戰鬥能力；\\n\\n沒有武將保護下的士兵會很容易被擊潰；\\n\\n利用對單能力強的武將斬殺敵對武將可快速擊破敵軍。"
"incidents_localised_title_xyy_roguelike_enemy_wood_2"	"「勇武之勢」等級提高：2級"
"incidents_localised_description_xyy_roguelike_enemy_wood_2"	"非玩家派系軍隊補給增加，支援範圍增加；戰場上表現為更高的武將格鬥能力，但士兵能力大幅削弱。 \\n\\n敵方武將會增強自身與周圍士兵的戰鬥能力；\\n\\n沒有武將保護下的士兵會很容易被擊潰；\\n\\n利用對單能力強的武將斬殺敵對武將可快速擊破敵軍。"
"incidents_localised_title_xyy_roguelike_enemy_wood_3"	"「勇武之勢」等級提高：3級"
"incidents_localised_description_xyy_roguelike_enemy_wood_3"	"非玩家派系軍隊補給增加，支援範圍增加；戰場上表現為更高的武將格鬥能力，但士兵能力大幅削弱。 \\n\\n敵方武將會增強自身與周圍士兵的戰鬥能力；\\n\\n沒有武將保護下的士兵會很容易被擊潰；\\n\\n利用對單能力強的武將斬殺敵對武將可快速擊破敵軍。"
"incidents_localised_title_xyy_roguelike_enemy_wood_4"	"「勇武之勢」等級提高：4級"
"incidents_localised_description_xyy_roguelike_enemy_wood_4"	"非玩家派系軍隊補給增加，支援範圍增加；戰場上表現為更高的武將格鬥能力，但士兵能力大幅削弱。 \\n\\n敵方武將會增強自身與周圍士兵的戰鬥能力；\\n\\n沒有武將保護下的士兵會很容易被擊潰；\\n\\n利用對單能力強的武將斬殺敵對武將可快速擊破敵軍。"
"incidents_localised_title_xyy_roguelike_enemy_wood_5"	"「勇武之勢」等級提高：5級"
"incidents_localised_description_xyy_roguelike_enemy_wood_5"	"非玩家派系軍隊補給增加，支援範圍增加；戰場上表現為更高的武將格鬥能力，但士兵能力大幅削弱。 \\n\\n敵方武將會增強自身與周圍士兵的戰鬥能力；\\n\\n沒有武將保護下的士兵會很容易被擊潰；\\n\\n利用對單能力強的武將斬殺敵對武將可快速擊破敵軍。"
"incidents_localised_title_xyy_roguelike_enemy_wood_6"	"「勇武之勢」已達最高等級：6級"
"incidents_localised_description_xyy_roguelike_enemy_wood_6"	"非玩家派系軍隊補給增加，支援範圍增加；戰場上表現為更高的武將格鬥能力，但士兵能力大幅削弱。 \\n\\n敵方武將會增強自身與周圍士兵的戰鬥能力；\\n\\n沒有武將保護下的士兵會很容易被擊潰；\\n\\n利用對單能力強的武將斬殺敵對武將可快速擊破敵軍。"
"incidents_localised_title_xyy_roguelike_enemy_metal_1"	"「固守之勢」"
"incidents_localised_description_xyy_roguelike_enemy_metal_1"	"非玩家派系軍隊補員增加，防守時不潰；戰場上表現為更高的防禦水平，但進攻能力大幅削弱。 \\n\\n對依賴造成物理傷害的士兵和武將會很不友善；\\n\\n可利用火焰、淬毒、流血等傷害快速擊破敵軍。"
"incidents_localised_title_xyy_roguelike_enemy_metal_2"	"「固守之勢」等級提高：2級"
"incidents_localised_description_xyy_roguelike_enemy_metal_2"	"非玩家派系軍隊補員增加，防守時不潰；戰場上表現為更高的防禦水平，但進攻能力大幅削弱。 \\n\\n對依賴造成物理傷害的士兵和武將會很不友善；\\n\\n可利用火焰、淬毒、流血等傷害快速擊破敵軍。"
"incidents_localised_title_xyy_roguelike_enemy_metal_3"	"「固守之勢」等級提高：3級"
"incidents_localised_description_xyy_roguelike_enemy_metal_3"	"非玩家派系軍隊補員增加，防守時不潰；戰場上表現為更高的防禦水平，但進攻能力大幅削弱。 \\n\\n對依賴造成物理傷害的士兵和武將會很不友善；\\n\\n可利用火焰、淬毒、流血等傷害快速擊破敵軍。"
"incidents_localised_title_xyy_roguelike_enemy_metal_4"	"「固守之勢」等級提高：4級"
"incidents_localised_description_xyy_roguelike_enemy_metal_4"	"非玩家派系軍隊補員增加，防守時不潰；戰場上表現為更高的防禦水平，但進攻能力大幅削弱。 \\n\\n對依賴造成物理傷害的士兵和武將會很不友善；\\n\\n可利用火焰、淬毒、流血等傷害快速擊破敵軍。"
"incidents_localised_title_xyy_roguelike_enemy_metal_5"	"「固守之勢」等級提高：5級"
"incidents_localised_description_xyy_roguelike_enemy_metal_5"	"非玩家派系軍隊補員增加，防守時不潰；戰場上表現為更高的防禦水平，但進攻能力大幅削弱。 \\n\\n對依賴造成物理傷害的士兵和武將會很不友善；\\n\\n可利用火焰、淬毒、流血等傷害快速擊破敵軍。"
"incidents_localised_title_xyy_roguelike_enemy_metal_6"	"「固守之勢」已達最高等級：6級"
"incidents_localised_description_xyy_roguelike_enemy_metal_6"	"非玩家派系軍隊補員增加，防守時不潰；戰場上表現為更高的防禦水平，但進攻能力大幅削弱。 \\n\\n對依賴造成物理傷害的士兵和武將會很不友善；\\n\\n可利用火焰、淬毒、流血等傷害快速擊破敵軍。"
"incidents_localised_title_xyy_roguelike_enemy_fire_1"	"「破陣之勢」"
"incidents_localised_description_xyy_roguelike_enemy_fire_1"	"非玩家派系移動範圍增加，進攻時不潰；戰場上表現為更高的移速，破甲和衝鋒加成，但防禦能力大幅削弱。 \\n\\n對近戰、護盾、防護類型的武將會很不友善；\\n\\n敵軍會非常懼怕遠程殺傷，可利用遠程單位快速擊破敵軍。"
"incidents_localised_title_xyy_roguelike_enemy_fire_2"	"「破陣之勢」等級提高：2級"
"incidents_localised_description_xyy_roguelike_enemy_fire_2"	"非玩家派系移動範圍增加，進攻時不潰；戰場上表現為更高的移速，破甲和衝鋒加成，但防禦能力大幅削弱。 \\n\\n對近戰、護盾、防護類型的武將會很不友善；\\n\\n敵軍會非常懼怕遠程殺傷，可利用遠程單位快速擊破敵軍。"
"incidents_localised_title_xyy_roguelike_enemy_fire_3"	"「破陣之勢」等級提高：3級"
"incidents_localised_description_xyy_roguelike_enemy_fire_3"	"非玩家派系移動範圍增加，進攻時不潰；戰場上表現為更高的移速，破甲和衝鋒加成，但防禦能力大幅削弱。 \\n\\n對近戰、護盾、防護類型的武將會很不友善；\\n\\n敵軍會非常懼怕遠程殺傷，可利用遠程單位快速擊破敵軍。"
"incidents_localised_title_xyy_roguelike_enemy_fire_4"	"「破陣之勢」等級提高：4級"
"incidents_localised_description_xyy_roguelike_enemy_fire_4"	"非玩家派系移動範圍增加，進攻時不潰；戰場上表現為更高的移速，破甲和衝鋒加成，但防禦能力大幅削弱。 \\n\\n對近戰、護盾、防護類型的武將會很不友善；\\n\\n敵軍會非常懼怕遠程殺傷，可利用遠程單位快速擊破敵軍。"
"incidents_localised_title_xyy_roguelike_enemy_fire_5"	"「破陣之勢」等級提高：5級"
"incidents_localised_description_xyy_roguelike_enemy_fire_5"	"非玩家派系移動範圍增加，進攻時不潰；戰場上表現為更高的移速，破甲和衝鋒加成，但防禦能力大幅削弱。 \\n\\n對近戰、護盾、防護類型的武將會很不友善；\\n\\n敵軍會非常懼怕遠程殺傷，可利用遠程單位快速擊破敵軍。"
"incidents_localised_title_xyy_roguelike_enemy_fire_6"	"「破陣之勢」已達最高等級：6級"
"incidents_localised_description_xyy_roguelike_enemy_fire_6"	"非玩家派系移動範圍增加，進攻時不潰；戰場上表現為更高的移速，破甲和衝鋒加成，但防禦能力大幅削弱。 \\n\\n對近戰、護盾、防護類型的武將會很不友善；\\n\\n敵軍會非常懼怕遠程殺傷，可利用遠程單位快速擊破敵軍。"
"incidents_localised_title_xyy_roguelike_enemy_water_1"	"「巧變之勢」"
"incidents_localised_description_xyy_roguelike_enemy_water_1"	"非玩家派系武將解鎖多種技能，更高的伏擊成功率；戰場上表現為技能冷卻時間減少，但戰鬥能力大幅削弱。 \\n\\n敵方武將會掌握大量技能；\\n\\n敵方武將和部隊作戰能力較弱，可利用鎖技能類型的武將擊破敵軍。"
"incidents_localised_title_xyy_roguelike_enemy_water_2"	"「巧變之勢」等級提高：2級"
"incidents_localised_description_xyy_roguelike_enemy_water_2"	"非玩家派系武將解鎖多種技能，更高的伏擊成功率；戰場上表現為技能冷卻時間減少，但戰鬥能力大幅削弱。 \\n\\n敵方武將會掌握大量技能；\\n\\n敵方武將和部隊作戰能力較弱，可利用鎖技能類型的武將擊破敵軍。"
"incidents_localised_title_xyy_roguelike_enemy_water_3"	"「巧變之勢」等級提高：3級"
"incidents_localised_description_xyy_roguelike_enemy_water_3"	"非玩家派系武將解鎖多種技能，更高的伏擊成功率；戰場上表現為技能冷卻時間減少，但戰鬥能力大幅削弱。 \\n\\n敵方武將會掌握大量技能；\\n\\n敵方武將和部隊作戰能力較弱，可利用鎖技能類型的武將擊破敵軍。"
"incidents_localised_title_xyy_roguelike_enemy_water_4"	"「巧變之勢」等級提高：4級"
"incidents_localised_description_xyy_roguelike_enemy_water_4"	"非玩家派系武將解鎖多種技能，更高的伏擊成功率；戰場上表現為技能冷卻時間減少，但戰鬥能力大幅削弱。 \\n\\n敵方武將會掌握大量技能；\\n\\n敵方武將和部隊作戰能力較弱，可利用鎖技能類型的武將擊破敵軍。"
"incidents_localised_title_xyy_roguelike_enemy_water_5"	"「巧變之勢」等級提高：5級"
"incidents_localised_description_xyy_roguelike_enemy_water_5"	"非玩家派系武將解鎖多種技能，更高的伏擊成功率；戰場上表現為技能冷卻時間減少，但戰鬥能力大幅削弱。 \\n\\n敵方武將會掌握大量技能；\\n\\n敵方武將和部隊作戰能力較弱，可利用鎖技能類型的武將擊破敵軍。"
"incidents_localised_title_xyy_roguelike_enemy_water_6"	"「巧變之勢」已達最高等級：6級"
"incidents_localised_description_xyy_roguelike_enemy_water_6"	"非玩家派系武將解鎖多種技能，更高的伏擊成功率；戰場上表現為技能冷卻時間減少，但戰鬥能力大幅削弱。 \\n\\n敵方武將會掌握大量技能；\\n\\n敵方武將和部隊作戰能力較弱，可利用鎖技能類型的武將擊破敵軍。"
"effect_bundles_localised_title_xyy_roguelike_52"	"勢不可擋"
"effect_bundles_localised_description_xyy_roguelike_52"	"你的武將破甲和非破甲傷害增加"
"mod_info_xyy_roguelike_52"	"所有武將的破甲和非破甲傷害+100%"
"effect_bundles_localised_title_xyy_roguelike_53"	"精力充沛"
"effect_bundles_localised_description_xyy_roguelike_53"	"你的武將和部曲免疫疲勞"
"mod_info_xyy_roguelike_53"	"所有武將和部曲獲得免疫疲勞屬性"
"effect_bundles_localised_title_xyy_roguelike_54"	"草木皆兵"
"effect_bundles_localised_description_xyy_roguelike_54"	"你的武將和部曲潛行強化"
"mod_info_xyy_roguelike_54"	"所有武將和部曲獲得“潛獵”屬性，可在大部分環境下隱藏自身"
"effect_bundles_localised_title_xyy_roguelike_craft_weapons"	"鍛造傳奇兵器"
"effect_bundles_localised_description_xyy_roguelike_craft_weapons"	"(3回合)你可以消耗資源點數鍛造傳奇武器，你需要擁有傳奇冶兵所。"
"mod_info_xyy_roguelike_craft_weapons"	"你可以消耗資源點數鍛造一把傳奇武器，你需要擁有至少1所傳奇冶兵所，3回合完成鍛造，該項目會重新在商店裡顯示。"
"effect_bundles_localised_title_xyy_roguelike_craft_armors"	"鑄造傳奇甲胄"
"effect_bundles_localised_description_xyy_roguelike_craft_armors"	"(2回合)你可以消耗資源點數製作一套傳奇護甲，你需要擁有傳奇鑄甲所。"
"mod_info_xyy_roguelike_craft_armors"	"你可以消耗資源點數製作一套傳奇護甲，你需要擁有至少1所傳奇鑄甲所，2回合完成製作，該項目會重新在商店裡顯示。"
"effect_bundles_localised_title_xyy_roguelike_craft_mounts"	"馴養傳奇馬匹"
"effect_bundles_localised_description_xyy_roguelike_craft_mounts"	"(4回合)你可以消耗資源點數馴養一匹傳奇馬，你需要擁有傳奇馴獸場。"
"mod_info_xyy_roguelike_craft_mounts"	"你可以消耗資源點數馴養一匹傳奇馬，你需要擁有至少1所傳奇馴獸場，4回合後獲取，該項目會重新在商店裡顯示。"
"effect_bundles_localised_title_xyy_roguelike_craft_accessories"	"搜羅傳奇見聞"
"effect_bundles_localised_description_xyy_roguelike_craft_accessories"	"(2回合)你可以消耗資源點數來獲得一件傳奇物件或傳奇侍從，你需要擁有皇宮。"
"mod_info_xyy_roguelike_craft_accessories"	"你可以消耗資源點數來獲得一件傳奇物件或傳奇侍從，你需要擁有至少1所皇宮，2回合後獲取，該物品會重新在商店裡顯示。"
"effect_bundles_localised_title_xyy_roguelike_craft_weapons_1"	"鍛造兵器"
"effect_bundles_localised_description_xyy_roguelike_craft_weapons_1"	"(3回合)你可以消耗資源點數鍛造武器，你需要擁有冶兵所或製弓所。"
"mod_info_xyy_roguelike_craft_weapons_1"	"你可以消耗資源點數鍛造一把武器，你需要擁有至少1所冶兵所或製弓所，3回合完成鍛造，該項目會重新在商店裡顯示。"
"effect_bundles_localised_title_xyy_roguelike_craft_armors_1"	"鑄造甲胄"
"effect_bundles_localised_description_xyy_roguelike_craft_armors_1"	"(2回合)你可以消耗資源點數製作一組護甲，你需要擁有鑄甲所。"
"mod_info_xyy_roguelike_craft_armors_1"	"你可以消耗資源點數製作一套護甲，你需要擁有至少1所鑄甲所，2回合完成製作，該項目會重新在商店裡顯示。"
"effect_bundles_localised_title_xyy_roguelike_craft_mounts_1"	"馴養馬匹"
"effect_bundles_localised_description_xyy_roguelike_craft_mounts_1"	"(4回合)你可以消耗資源點數馴養一匹馬，你需要擁有馬場。"
"mod_info_xyy_roguelike_craft_mounts_1"	"你可以消耗資源點數馴養一匹馬，你需要擁有至少1所馬場，4回合後獲取，該項目會重新在商店裡顯示。"
"effect_bundles_localised_title_xyy_roguelike_craft_accessories_1"	"搜羅見聞"
"effect_bundles_localised_description_xyy_roguelike_craft_accessories_1"	"(2回合)你可以消耗資源點數來獲得一件傳奇物件或傳奇侍從，你需要擁有郡府。"
"mod_info_xyy_roguelike_craft_accessories_1"	"你可以消耗資源點數來獲得一件傳奇物品或傳件侍從，你需要擁有至少1所郡府，2回合後獲取，該項目會重新在商店裡顯示。"
"mod_xyy_roguelike_icon_no_building"	"你缺少對應的建築。"
"mod_xyy_roguelike_icon_stopped"	"已終止，你缺少對應的建築。"
"mod_xyy_store_main_message_craft"	"你獲得了[[col:%1]][[b]]%2[[/b]][[/col]]"
"missions_localised_title_xyy_roguelike_kill_hlyjci_dark"	"「逐鹿天下」擊敗惡墮者"
"missions_localised_description_xyy_roguelike_kill_hlyjci_dark"	"惡墮者・甘雨是甘雨的邪惡克隆人，其恐怖的四連發霜華矢可以在超遠距離下對我方陣地進行毀滅打擊，並造成凍結減速效果。惡墮者・甘雨善於隱藏在樹林、草叢、丘陵之中，總是能出現在意想不到的位置對我方陣地進行偷襲。"
"campaign_payload_ui_details_description_kill_hlyjci_dark"	"亡故角色：惡墮者・甘雨"
"missions_localised_title_xyy_roguelike_kill_hlyjcj_dark"	"「逐鹿天下」擊敗惡墮者"
"missions_localised_description_xyy_roguelike_kill_hlyjcj_dark"	"惡墮者・卡芙卡是卡芙卡的邪惡克隆人，如果說卡芙卡是很強力的清兵角色，那麼惡墮者則有過之而無不及。惡墮者・卡芙卡擁有超高的技能轉速，以及高額的持續穿盾傷害，更能讓我方武將進入狂暴狀態，導致被動技能失效。沒有人能站著從她的大招範圍走出來。"
"campaign_payload_ui_details_description_kill_hlyjcj_dark"	"亡故角色：惡墮者・卡芙卡"
"missions_localised_title_xyy_roguelike_kill_hlyjck_dark"	"「逐鹿天下」擊敗惡墮者"
"missions_localised_description_xyy_roguelike_kill_hlyjck_dark"	"惡墮者・鏡流是鏡流的邪惡克隆人，本身墮入魔陰對鏡流而言已經是壞消息，而惡墮者則更是火上澆油，雪上加霜。惡墮者・鏡流擁有恐怖的全場範圍技能，並且在脫戰狀態下會持續回血。但別以為讓她陷入近戰就可以解決問題，近戰狀態下，她的魔陰身會傳導至我方，導致我方將士持續損失生命值和士氣。"
"campaign_payload_ui_details_description_kill_hlyjck_dark"	"亡故角色：惡墮者・鏡流"
"missions_localised_title_xyy_roguelike_kill_hlyjcm_dark"	"「逐鹿天下」擊敗惡墮者"
"missions_localised_description_xyy_roguelike_kill_hlyjcm_dark"	"惡墮者・雷電將軍是雷電將軍的邪惡克隆人，雷電將軍的無想的一刀已經足夠令人頭疼，而惡墮者則擁有無想的十刀。惡墮者・雷電將軍是迄今為止最恐怖的克隆人之一，其無想的十刀甚至可在瞬間全殲我方的兵力，一定要避免和她正面交鋒！"
"campaign_payload_ui_details_description_kill_hlyjcm_dark"	"亡故角色：惡墮者・雷電將軍"
"missions_localised_title_xyy_roguelike_kill_hlyjcn_dark"	"「逐鹿天下」擊敗惡墮者"
"missions_localised_description_xyy_roguelike_kill_hlyjcn_dark"	"惡墮者・刻晴是刻晴的邪惡克隆人，擁有不錯的近戰能力，其超高的技能轉速很容易對我方造成巨大的傷亡。惡墮者・刻晴同時有著十分出色的防禦能力，其免疫大部分的攻擊手段。也許只能利用穿盾、流血等機制對其造成有效的殺傷了。"
"campaign_payload_ui_details_description_kill_hlyjcn_dark"	"亡故角色：惡墮者・刻晴"
"missions_localised_title_xyy_roguelike_kill_hlyjcy_dark"	"「逐鹿天下」擊敗惡墮者"
"missions_localised_description_xyy_roguelike_kill_hlyjcy_dark"	"惡墮者・夜蘭是夜蘭的邪惡克隆人，擁有強大的遠程打擊能力。務必小心她的強化「破局矢」，其會在命中區域造成範圍爆炸，對我方將士造成大量的傷害。與之近距離交戰也許是唯一可行的選擇。"
"campaign_payload_ui_details_description_kill_hlyjcy_dark"	"亡故角色：惡墮者・夜蘭"
"missions_localised_title_xyy_roguelike_kill_hlyjda_dark"	"「逐鹿天下」擊敗惡墮者"
"missions_localised_description_xyy_roguelike_kill_hlyjda_dark"	"惡墮者・優菈是優菈的邪惡克隆人，擁有超高的技能轉速，在擁有超高技能傷害的前提下還會對周圍的士兵造成減速和士氣打擊。應該盡量避免與之近戰，她的技能會造成非常高的傷害，同時自身免疫大部分物理攻擊。"
"campaign_payload_ui_details_description_kill_hlyjda_dark"	"亡故角色：惡墮者・優菈"
"missions_localised_title_xyy_roguelike_kill_hlyjdi_dark"	"「逐鹿天下」擊敗惡墮者"
"missions_localised_description_xyy_roguelike_kill_hlyjdi_dark"	"惡墮者・吟霖是吟霖的邪惡克隆人，在近戰時會鎖定我方武將技能，並且造成我方部隊減速和持續損失生命值（觸電）。我應該盡量避免與之近戰，她的技能會造成我方士兵的大量傷亡。"
"campaign_payload_ui_details_description_kill_hlyjdi_dark"	"亡故角色：惡墮者・吟霖"
"missions_localised_title_xyy_roguelike_kill_hlyjdf_dark"	"「逐鹿天下」擊敗惡墮者"
"missions_localised_description_xyy_roguelike_kill_hlyjdf_dark"	"惡墮者・九條裟羅是九條裟羅的邪惡複製人，迄今最難應付的敵人之一。其四聯裝「鴉羽天狗霆雷召咒」可以在短時間內對我方士兵造成巨額傷亡，近戰狀態也擁有大範圍的清兵技能。"
"campaign_payload_ui_details_description_kill_hlyjdf_dark"	"亡故角色：惡墮者・九條裟羅"
"effect_bundles_localised_title_dark_character_easy"	"[[img:pooled_resource_credibility]][[/img]]+500"
"effect_bundles_localised_title_dark_character_normal"	"[[img:pooled_resource_credibility]][[/img]]+700"
"effect_bundles_localised_title_dark_character_hard"	"[[img:pooled_resource_credibility]][[/img]]+1000"
"mission_text_xyy_roguelike_kill_hlyjci_dark"	"（可選）在戰鬥中殺死惡墮者・甘雨"
"mission_text_xyy_roguelike_kill_hlyjcj_dark"	"（可選）在戰鬥中殺死惡墮者・卡芙卡"
"mission_text_xyy_roguelike_kill_hlyjck_dark"	"（可選）在戰鬥中殺死惡墮者・鏡流"
"mission_text_xyy_roguelike_kill_hlyjcm_dark"	"（可選）在戰鬥中殺死惡墮者・雷電將軍"
"mission_text_xyy_roguelike_kill_hlyjcn_dark"	"（可選）在戰鬥中殺死惡墮者・刻晴"
"mission_text_xyy_roguelike_kill_hlyjcy_dark"	"（可選）在戰鬥中殺死惡墮者・夜蘭"
"mission_text_xyy_roguelike_kill_hlyjda_dark"	"（可選）在戰鬥中殺死惡墮者・優菈"
"mission_text_xyy_roguelike_kill_hlyjdi_dark"	"（可選）在戰鬥中殺死惡墮者・吟霖"
"mission_text_xyy_roguelike_kill_hlyjdf_dark"	"（可選）在戰鬥中殺死惡墮者・九條裟羅"
"map_pins_localised_title_hlyjci_dark"	"惡墮者"
"map_pins_localised_description_hlyjci_dark"	"任務目標"
"map_pins_localised_title_hlyjcj_dark"	"惡墮者"
"map_pins_localised_description_hlyjcj_dark"	"任務目標"
"map_pins_localised_title_hlyjck_dark"	"惡墮者"
"map_pins_localised_description_hlyjck_dark"	"任務目標"
"map_pins_localised_title_hlyjcm_dark"	"惡墮者"
"map_pins_localised_description_hlyjcm_dark"	"任務目標"
"map_pins_localised_title_hlyjcn_dark"	"惡墮者"
"map_pins_localised_description_hlyjcn_dark"	"任務目標"
"map_pins_localised_title_hlyjcy_dark"	"惡墮者"
"map_pins_localised_description_hlyjcy_dark"	"任務目標"
"map_pins_localised_title_hlyjda_dark"	"惡墮者"
"map_pins_localised_description_hlyjda_dark"	"任務目標"
"map_pins_localised_title_hlyjdi_dark"	"惡墮者"
"map_pins_localised_description_hlyjdi_dark"	"任務目標"
"map_pins_localised_title_hlyjdf_dark"	"惡墮者"
"map_pins_localised_description_hlyjdf_dark"	"任務目標"
"missions_localised_title_xyy_roguelike_kill_hlyjdt_dark"	"「逐鹿天下」擊敗惡墮者"
"missions_localised_description_xyy_roguelike_kill_hlyjdt_dark"	"惡墮者・申鶴是申鶴的邪惡克隆人，惡墮者・申鶴會召喚其惡墮「籙靈」加入戰鬥，「籙靈」會對我方造成高額傷害，並且使我方隊伍的護盾失效，還能造成減速。 「籙靈」倒下後會爆炸，對我方造成二次傷害。"
"campaign_payload_ui_details_description_kill_hlyjdt_dark"	"亡故角色：惡墮者・申鶴"
"mission_text_xyy_roguelike_kill_hlyjdt_dark"	"（可選）在戰鬥中殺死惡墮者・申鶴"
"map_pins_localised_title_hlyjdt_dark"	"惡墮者"
"map_pins_localised_description_hlyjdt_dark"	"任務目標"
"effect_bundles_localised_title_xyy_roguelike_55"	"陰險狡詐"
"effect_bundles_localised_description_xyy_roguelike_55"	"所有武將和部曲都可以遊擊部署"
"mod_info_xyy_roguelike_55"	"所有武將和部曲啟用「遊擊部署」"
"effect_bundles_localised_title_xyy_roguelike_56"	"強化武器"
"effect_bundles_localised_description_xyy_roguelike_56"	"部曲的近戰殺傷力微增加"
"mod_info_xyy_roguelike_56"	"所有部隊的破甲和非破甲傷害+10%"
"effect_bundles_localised_title_xyy_roguelike_57"	"制式武器"
"effect_bundles_localised_description_xyy_roguelike_57"	"部曲的近戰殺傷幅度增加"
"mod_info_xyy_roguelike_57"	"所有部隊的破甲和非破甲傷害+20%"
"effect_bundles_localised_title_xyy_roguelike_58"	"精鍛武器"
"effect_bundles_localised_description_xyy_roguelike_58"	"部曲的近戰殺傷大幅增加"
"mod_info_xyy_roguelike_58"	"所有部隊的破甲和非破甲傷害+40%"
"effect_bundles_localised_title_xyy_roguelike_59"	"十日練兵"
"effect_bundles_localised_description_xyy_roguelike_59"	"部曲的近戰和遠程防禦微增加"
"mod_info_xyy_roguelike_59"	"所有部隊的近戰閃避和遠程格擋+5%"
"effect_bundles_localised_title_xyy_roguelike_60"	"百日練兵"
"effect_bundles_localised_description_xyy_roguelike_60"	"部曲的近戰和遠程防禦中幅增加"
"mod_info_xyy_roguelike_60"	"所有部隊的近戰閃避和遠程格擋+10%"
"effect_bundles_localised_title_xyy_roguelike_61"	"千日練兵"
"effect_bundles_localised_description_xyy_roguelike_61"	"部曲的近戰和遠程防禦大幅增加"
"mod_info_xyy_roguelike_61"	"所有部隊的近戰閃避和遠程格擋+20%"
"effect_bundles_localised_title_xyy_roguelike_62"	"火燒連營"
"effect_bundles_localised_description_xyy_roguelike_62"	"所有部隊解鎖燃火箭矢和燃燒砲彈"
"mod_info_xyy_roguelike_62"	"所有部隊解鎖燃火箭矢和燃燒砲彈"
"effect_bundles_localised_title_xyy_roguelike_63"	"徵召入伍"
"effect_bundles_localised_description_xyy_roguelike_63"	"派系範圍內部隊補員效率微提升"
"mod_info_xyy_roguelike_63"	"派系範圍內部隊補員+5%，最大為50%"
"effect_bundles_localised_title_xyy_roguelike_64"	"擴充軍備"
"effect_bundles_localised_description_xyy_roguelike_64"	"派系範圍內部隊補員效率中幅提升"
"mod_info_xyy_roguelike_64"	"派系範圍內部隊補員+10%，最大為50%"
"effect_bundles_localised_title_xyy_roguelike_65"	"兵源充足"
"effect_bundles_localised_description_xyy_roguelike_65"	"派系範圍內部隊補員效率大幅提升"
"mod_info_xyy_roguelike_65"	"派系範圍內部隊補員+20%，最大為50%"
"effect_bundles_localised_title_xyy_roguelike_66"	"差強人意"
"effect_bundles_localised_description_xyy_roguelike_66"	"派系範圍內所有人物會滿意度提升"
"mod_info_xyy_roguelike_66"	"當一名人物滿意度高於50，則額外獲得25點滿意度；當一名人物滿意度低於50，則額外獲得50點滿意度；當一名人物滿意度低於25，則額外獲得75點滿意度"
"effect_bundles_localised_title_xyy_roguelike_sima_yi"	"鷹視狼顧"
"effect_bundles_localised_description_xyy_roguelike_sima_yi"	"司馬懿加入陣營"
"mod_info_xyy_roguelike_sima_yi"	"司馬懿加入陣營"
"effect_bundles_localised_title_xyy_roguelike_67"	"雕蟲小技"
"effect_bundles_localised_description_xyy_roguelike_67"	"敵方部隊伏擊必定失敗"
"mod_info_xyy_roguelike_67"	"派系範圍內，所有部隊避免遭遇伏擊機率+100%"
"missions_localised_title_xyy_roguelike_kill_hlyjdy_dark"	"「逐鹿天下」擊敗惡墮者"
"missions_localised_description_xyy_roguelike_kill_hlyjdy_dark"	"惡墮者・珂萊塔是珂萊塔的邪惡克隆人，惡墮者・珂萊塔的遠程攻擊極強，命中率極高，如果不能有效靠近，那麼將對戰局極為不利。"
"campaign_payload_ui_details_description_kill_hlyjdy_dark"	"亡故角色：惡墮者・珂萊塔"
"mission_text_xyy_roguelike_kill_hlyjdy_dark"	"（可選）在戰鬥中殺死惡墮者・珂萊塔"
"map_pins_localised_title_hlyjdy_dark"	"惡墮者"
"map_pins_localised_description_hlyjdy_dark"	"任務目標"
"mod_store_disble_reason_the_seven_kings_dead"	"[[col:effect_icon_supplement_negative]][[b]]此項目不可用[[/b]][[/col]]\\n七王已隕落\\n\\n"
"mod_store_disble_reason_already_have_character"	"[[col:effect_icon_supplement_negative]][[b]]此項目不可用[[/b]][[/col]]\\n你的派系已擁有此人物\\n\\n"
"mod_store_disble_reason_character_dead"	"[[col:effect_icon_supplement_negative]][[b]]此項目不可用[[/b]][[/col]]\\n此人物已亡故\\n\\n"
"effect_bundles_localised_title_xyy_roguelike_enemy_earth"	"「天命之勢」"
"effect_bundles_localised_description_xyy_roguelike_enemy_earth"	"敵方擁有不潰和遠程抗性，但抵抗衝鋒能力大幅削弱。"
"mod_info_xyy_roguelike_enemy_earth"	"非玩家派系腐敗減少，公共秩序增加；戰場上表現為不潰和遠程抗性，但抵抗衝鋒能力大幅削弱。 \\n\\n對遠程單位和依賴遠程攻擊和技能的武將會很不友善；\\n\\n可利用騎兵和增強衝擊騎兵的武將快速擊破敵軍。"
"effect_bundles_localised_title_xyy_roguelike_enemy_wood"	"「勇武之勢」"
"effect_bundles_localised_description_xyy_roguelike_enemy_wood"	"敵方擁有更高的武將格鬥能力，但士兵能力大幅削弱。"
"mod_info_xyy_roguelike_enemy_wood"	"非玩家派系軍隊補給增加，支援範圍增加；戰場上表現為更高的武將格鬥能力，但士兵能力大幅削弱。 \\n\\n敵方武將會增強自身與周圍士兵的戰鬥能力；\\n\\n沒有武將保護下的士兵會很容易被擊潰；\\n\\n利用對單能力強的武將斬殺敵對武將可快速擊破敵軍。"
"effect_bundles_localised_title_xyy_roguelike_enemy_metal"	"「固守之勢」"
"effect_bundles_localised_description_xyy_roguelike_enemy_metal"	"敵方擁有更高的防禦水平，但進攻能力大幅削弱。"
"mod_info_xyy_roguelike_enemy_metal"	"非玩家派系軍隊補員增加，防守時不潰；戰場上表現為更高的防禦水平，但進攻能力大幅削弱。 \\n\\n對依賴造成物理傷害的士兵和武將會很不友善；\\n\\n可利用火焰、淬毒、流血等傷害快速擊破敵軍。"
"effect_bundles_localised_title_xyy_roguelike_enemy_fire"	"「破陣之勢」"
"effect_bundles_localised_description_xyy_roguelike_enemy_fire"	"敵方擁有更高的移速，破甲和衝鋒加成，但防禦能力大幅削弱。"
"mod_info_xyy_roguelike_enemy_fire"	"非玩家派系移動範圍增加，進攻時不潰；戰場上表現為更高的移速，破甲和衝鋒加成，但防禦能力大幅削弱。 \\n\\n對近戰、護盾、防護類型的武將會很不友善；\\n\\n敵軍會非常懼怕遠程殺傷，可利用遠程單位快速擊破敵軍。"
"effect_bundles_localised_title_xyy_roguelike_enemy_water"	"「巧變之勢」"
"effect_bundles_localised_description_xyy_roguelike_enemy_water"	"敵方掌握匿蹤和各類技能，技能冷卻時間減少，但作戰能力大幅削弱。"
"mod_info_xyy_roguelike_enemy_water"	"非玩家派系武將解鎖多種技能，更高的伏擊成功率；戰場上表現為技能冷卻時間減少，但戰鬥能力大幅削弱。 \\n\\n敵方武將會掌握大量技能；\\n\\n敵方武將和部隊作戰能力較弱，可利用鎖技能類型的武將擊破敵軍。"
"mod_xyy_character_roguelike_select_enemy_effect"	"[[col:flavour]]選擇逐鹿之勢[[/col]]"
"missions_localised_title_xyy_roguelike_kill_hlyjeb_dark"	"「逐鹿天下」击败恶堕者"
"missions_localised_description_xyy_roguelike_kill_hlyjeb_dark"	"恶堕者・坎特蕾拉是坎特蕾拉的邪恶克隆人，恶堕者・坎特蕾拥有极高的清兵效率，并限制我方武将的发挥。"
"campaign_payload_ui_details_description_kill_hlyjeb_dark"	"亡故角色：恶堕者・坎特蕾拉"
"mission_text_xyy_roguelike_kill_hlyjeb_dark"	"（可选）在战斗中杀死恶堕者・坎特蕾拉"
"mod_title_xyy_roguelike_enemy_earth"	"「天命」"
"mod_title_xyy_roguelike_enemy_wood"	"「勇武」"
"mod_title_xyy_roguelike_enemy_metal"	"「固守」"
"mod_title_xyy_roguelike_enemy_fire"	"「破阵」"
"mod_title_xyy_roguelike_enemy_water"	"「巧变」"
